W W W W W W W W W W W W W W W W W
W - - - - - - - - - - - - - - - W
W - - - - - - - - - - - - - - - W
W - - - - - - - - - - - - - - - W
W - - - B - - - - - - P - - - - W
W - - - - - - - - - - - - - - - W
W - - - - - - - - - - - - - - - W
W - - - - - - S - - - - - - - - W
W - - - - - - - - - - - - - - - W
W - - - - - - - - - - - - - - - W
W - - - - - - - - - - - - - - - W
W W W W W W W W W W W W W W W W W